R R S S S S S S S Q
R S S S S S S S S Q
S S S S S R R S S Q
S Q S S S S S S S S
S Q S S S Q S S R R
S Q S R S S Q S S R
S S S R R S S Q S R
S Q Q Q S S S S S S