R R S S S S S S R R
S S R S S S S S S S
Q S S S S S R R S S
Q S S Q S S S S S Q
Q S S S Q S S S S Q
S S S S S Q S S S Q
S R S S S S S S S S
R R S S S Q Q Q S S