R R S Q S S R S S S
R S S Q S S R Q Q Q
S S S Q S R S S S S
S S S S S S S S R S
S Q S S S Q R R S S
S Q R S S Q S S S Q
S Q S R R Q S S Q S
R S S R S S S Q S R